{
"w":8,
"h":8,
"fishes":[
[0, 2, 0, 0, 0, 1, 0, 0],
[1, 5, 0, 3, 1, 0, 0, 0],
[2, 3, 1, 1, 0, 0, 0, 0],
[3, 6, 1, 0, 0, 0, 0, 0],
[4, 0, 2, 3, 0, 0, 0, 0],
[5, 1, 2, 0, 1, 1, 0, 0],
[6, 4, 2, 3, 1, 0, 0, 0],
[7, 2, 3, 3, 0, 0, 0, 0],
[8, 5, 3, 0, 0, 0, 0, 0],
[9, 1, 4, 2, 0, 0, 0, 0],
[10, 6, 3, 0, 0, 0, 0, 1],
[11, 2, 4, 2, 0, 0, 0, 1],
[12, 5, 4, 1, 0, 0, 0, 1],
[13, 3, 5, 1, 1, 0, 0, 1],
[14, 6, 5, 2, 1, 1, 0, 1],
[15, 7, 5, 1, 0, 0, 0, 1],
[16, 1, 6, 2, 0, 0, 0, 1],
[17, 4, 6, 3, 0, 0, 0, 1],
[18, 2, 7, 1, 1, 0, 0, 1],
[19, 5, 7, 2, 0, 1, 0, 1]],
"foods":[
[20, 3, 0],
[21, 5, 2],
[22, 2, 5],
[23, 4, 7]],
"trashes":[
[24, 4, 1],
[25, 3, 3],
[26, 4, 4],
[27, 3, 6]],
"nets":[
[28, 1, 3],
[29, 6, 4]],
"teleports":[
[30, 0, 1, 31],
[31, 7, 6, 30],
[32, 7, 2, 33],
[33, 0, 5, 32]]
,"constants":[1,1,1,1,3,1,1,1,1,1,1,1,1,1,1,1,1,1,1,1,1]

}